NO ./path_to_the_north_texture
SO ./path_to_the_south_texture

WE ./path_to_the_west_texture

EA ./path_to_the_east_texture



C 255,30,255

F 220,100,0




11111111111
11110111111
11110111111
11110001111
11110001111
11110N11111
11110001111
11110001111
11110001111
11110001111
11111111111
