NO ./textures/redbrick.png
SO ./textures/bluestone.png

WE ./textures/colorstone.png

EA ./textures/mossy.png



C 135,206,235

F 220,100,0


11111111
11110111111111111111111111111111111111
   11111    110000000011000000000000111
    1001     11011000001110000000000001111
    1111    111001000000000000000111111
1111111111111001110000000000001111
10000000001100000111011111111111111
111101111111110111000000100011    1
111101111 111110111010100100011  11
110000001111010110000000100011 111
100000N0000000001100000010001111
10000000000000001101010010001011
10000011110101011111011110001011
11110111 1100101110111101000101
11111111 1111111111111111111111
11111111 1111111111111111111111
                    111 11 111111111111111111