NO ./path_to_the_north_texture
SO ./path_to_the_south_texture
WE ./path_to_the_west_texture

EA ./path_to_the_east_texture



C 225,30,255
F 220,100,0




111111
11110111111111111111111111111111111111
   1111     110000000011000000000000111
    1  1     1101100000111000000000000111
     11     111001000000000000001111111
111111111111100111000000000000111
10000000001100000111011111111111111
11110111111111011100000010001    1
111101111111110111010100100011  11
11000000110101011000000010001 111
10000000000000001100000010001111
10000000000000001101010010001011
100000N1110101011111011110001011
11110111 1100101110111101000101
11111111 1111111111111111111111
11111111 1111111111111111111111
                    111 11 111
